exon_1	TTCCAGGACTGCAGAACTGGCCCAGACCTCTGTATTGGAAAGGTCTTTATGGACCAGGGAGTCCGGTGTCTTTTTTACGGGGGACCCCTGGGCTGCGAGTTGCACAGTCCAATTCGCTGTTGTTAGGGCCTCAGTTTCCCAAAAGGCACAGGGACGGGGGGAGGGTGGCGGCTCGATGGGGGAGCCGCCTCCAGGGGGCCCCCCCGCCCTGTGCCCACGGCGCGGCCCCTTTAAGAGGCCCGCCTGGCTCCGTCATCCGCGCCGCGGCCACCTCCCCCCGGCCCTCCCCTTCCTGCGGCGCAGAGTGCGGGCCGGGCGGGAGTGCGGCGAGAGCCGGCTGGCTGAGCTTAGCGTCCGAGGAGGCGGCGGCGGCGGCGGCGGCACGGCGGCGGCGGGGCTGTGGGGCGGTGCGGAAGCGAGAGGCGAGGAGCGCGCGGGCCGTGGCCAGAGTCTGGCGGCGGCCTGGCGGAGCGGAGAGCAGCGCCCGCGCCTCGCCGTGCGGAGGAGCCCCGCACACAATAGCGGCGCGCGCAGCCCGCGCCCTTCCCCCCGGCGCGCCCCGCCCCGCGCGCCGAGCGCCCCGCTCCGCCTCACCTGCCACCAGGGAGTGGGCGGGCATTGTTCGCCGCCGCCGCCGCCGCGCGGGCCATGGGGGCCGCCCGGCGCCCGGGGCCGGGCTGGCGAGGCGCCGCGCCGCCGCTGAGACGGGCCCCGCGCGCAGCCCGGCGGCGCAGGTAAGGCCGGCCGCGCCATGGTGGACCCGGTGGGCTTCGCGGAGGCGTGGAAGGCGCAGTTCCCGGACTCAGAGCCCCCGCGCATGGAGCTGCGCTCAGTGGGCGACATCGAGCAGGAGCTGGAGCGCTGCAAGGCCTCCATTCGGCGCCTGGAGCAGGAGGTGAACCAGGAGCGCTTCCGCATGATCTACCTGCAGACGTTGCTGGCCAAGGAAAAGAAGAGCTATGACCGGCAGCGATGGGGCTTCCGGCGCGCGGCGCAGGCCCCCGACGGCGCCTCCGAGCCCCGAGCGTCCGCGTCGCGCCCGCAGCCAGCGCCCGCCGACGGAGCCGACCCGCCGCCCGCCGAGGAGCCCGAGGCCCGGCCCGACGGCGAGGGTTCTCCGGGTAAGGCCAGGCCCGGGACCGCCCGCAGGCCCGGGGCAGCCGCGTCGGGGGAACGGGACGACCGGGGACCCCCCGCCAGCGTGGCGGCGCTCAGGTCCAACTTCGAGCGGATCCGCAAGGGCCATGGCCAGCCCGGGGCGGACGCCGAGAAGCCCTTCTACGTGAACGTCGAGTTTCACCACGAGCGCGGCCTGGTGAAGGTCAACGACAAAGAGGTGTCGGACCGCATCAGCTCCCTGGGCAGCCAGGCCATGCAGATGGAGCGCAAAAAGTCCCAGCACGGCGCGGGCTCGAGCGTGGGGGATGCATCCAGGCCCCCTTACCGGGGACGCTCCTCGGAGAGCAGCTGCGGCGTCGACGGCGACTACGAGGACGCCGAGTTGAACCCCCGCTTCCTGAAGGACAACCTGATCGACGCCAATGGCGGTAGCAGGCCCCCTTGGCCGCCCCTGGAGTACCAGCCCTACCAGAGCATCTACGTCGGGGGCATGATGGAAGGGGAGGGCAAGGGCCCGCTCCTGCGCAGCCAGAGCACCTCTGAGCAGGAGAAGCGCCTTACCTGGCCCCGCAGGTCCTACTCCCCCCGGAGTTTTGAGGATTGCGGAGGCGGCTATACCCCGGACTGCAGCTCCAATGAGAACCTCACCTCCAGCGAGGAGGACTTCTCCTCTGGCCAGTCCAGCCGCGTGTCCCCAAGCCCCACCACCTACCGCATGTTCCGGGACAAAAGCCGCTCTCCCTCGCAGAACTCGCAACAGTCCTTCGACAGCAGCAGTCCCCCCACGCCGCAGTGCCATAAGCGGCACCGGCACTGCCCGGTTGTCGTGTCCGAGGCCACCATCGTGGGCGTCCGCAAGACCGGGCAGATCTGGCCCAACGATGGCGAGGGCGCCTTCCATGGAGACGCAG
exon_2	ATGGCTCGTTCGGAACACCACCTGGATACGGCTGCGCTGCAGACCGGGCAGAGGAGCAGCGCCGGCACCAAGATGGGCTGCCCTACATTGATGACTCGCCCTCCTCATCGCCCCACCTCAGCAGCAAGGGCAGGGGCAGCCGGGATGCGCTGGTCTCGGGAGCCCTGGAGTCCACTAAAGCG
exon_3	AGTGAGCTGGACTTGGAAAAGGGCTTGGAGATGAGAAAATGGGTCCTGTCGGGAATCCTGGCTAGCGAGGAGACTTACCTGAGCCACCTGGAGGCACTGCTGCTG
exon_4	CCCATGAAGCCTTTGAAAGCCGCTGCCACCACCTCTCAGCCGGTGCTGACGAGTCAGCAGATCGAGACCATCTTCTTCAAAGTGCCTGAGCTCTACGAGATCCACAAGGAGTTCTATGATGGGCTCTTCCCCCGCGTGCAGCAGTGGAGCCACCAGCAGCGGGTGGGCGACCTCTTCCAGAAGCTG
exon_5	GCCAGCCAGCTGGGTGTGTACCGGGCCTTCGTGGACAACTACGGAGTTGCCATGGAAATGGCTGAGAAGTGCTGTCAGGCCAATGCTCAGTTTGCAGAAATCTCCGAG
exon_6	AACCTGAGAGCCAGAAGCAACAAAGATGCCAAGGATCCAACGACCAAGAACTCTCTGGAAA
exon_7	CTCTGCTCTACAAGCCTGTGGACCGTGTGACGAGGAGCACGCTGGTCCTCCAT
exon_8	GACTTGCTGAAGCACACTCCTGCCAGCCACCCTGACCACCCCTTGCTGCAGGACGCCCTCCGCATCTCACAGAACTTCCTGTCCAGCATCAATGAGGAGATCACACCCCGACGGCAGTCCATGACGGTGAAGAAGGGAGAG
exon_9	CACCGGCAGCTGCTGAAGGACAGCTTCATGGTGGAGCTGGTGGAGGGGGCCCGCAAGCTGCGCCACGTCTTCCTGTTCACCGACCTGCTTCTCTGCACCAAGCTCAAGAAGCAGAGCGGAGG
exon_10	CAAAACGCAGCAGTATGACTGCAAATGGTACATTCCGCTCACGGATCTCAGCTTCCAGATGGTGGATGAACTGGAGGCAGTGCCCAACATCCCCCTGGTGCCCGATGAGGAGCTGGACGCTTTGAAGATCAAGATCTCCCAGATCAAGAATGACATCCAGAGAGAGAAG
exon_11	AGGGCGAACAAGGGCAGCAAGGCTACGGAGAGGCTGAAGAAGAAGCTGTCGGAGCAGGAGTCACTGCTGCTGCTTATGTCTCCCAGCATGGCCTTCAGGGTGCACAGCCGCAACGGCAAG
exon_12	AGTTACACGTTCCTGATCTCCTCTGACTATGAGCGTGCAGAGTGGAGGGAGAACATCCGGGAGCAGCAGAAGAAGT
exon_13	GTTTCAGAAGCTTCTCCCTGACATCCGTGGAGCTGCAGATGCTGACCAACTCGTGTGTGAAACTCCAGACTGTCCACAGCATTCCGCTGACCATCAATAAGGAAG
exon_14	ATGATGAGTCTCCGGGGCTCTATGGGTTTCTGAATGTCATCGTCCACTCAGCCACTGGATTTAAGCAGAGTTCAA
exon_15	ATCTGTACTGCACCCTGGAGGTGGATTCCTTTGGGTATTTTGTGAATAAAGCAAAGACGCGCGTCTACAGGGACACAGCTGAGCCAAACTGGAACGAG
exon_16	GAATTTGAGATAGAGCTGGAGGGCTCCCAGACCCTGAGGATACTGTGCTATGAAAAGTGTTACAACAAGACGAAGATCCCCAAGGAGGACGGCGAGAGCACGGACAGACTCATGGGGAAGGGCCAGGTCCAG
exon_17	CTGGACCCGCAGGCCCTGCAGGACAGAGACTGGCAGCGCACCGTCATCGCCATGAATGGG
exon_18	ATCGAAGTAAAGCTCTCGGTCAAGTTCAACAGCAGGGAGTTCAGCTTGAAGAGGATGCCGTCCCGAAAACAGACAGGGGTCTTCGGAGTCAAGATTGCTGTGGTCACCAA
exon_19	GAGAGAGAGGTCCAAGGTGCCCTACATCGTGCGCCAGTGCGTGGAGGAGATCGAGCGCCGAGGCATGGAGGAGGTGGGCATCTACCGCGTGTCCGGTGTGGCCACGGACATCCAGGCACTGAAGGCAGCCTTCGACGTCA
exon_20	ATAACAAGGACGTGTCGGTGATGATGAGCGAGATGGACGTGAACGCCATCGCAGGCACGCTGAAGCTGTACTTCCGTGAGCTGCCCGAGCCCCTCTTCACTGACGAGTTCTACCCCAACTTCGCAGAGGGCATCG
exon_21	CTCTTTCAGACCCGGTTGCAAAGGAGAGCTGCATGCTCAACCTGCTGCTGTCCCTGCCGGAGGCCAACCTGCTCACCTTCCTTTTCCTTCTGGACCACCTGAAAAG
exon_22	GGTGGCAGAGAAGGAGGCAGTCAATAAGATGTCCCTGCACAACCTCGCCACGGTCTTTGGCCCCACGCTGCTCCGGCCCTCCGAGAAGGAGAGCAAGCTCCCTGCCAACCCCAGCCAGCCTATCACCATGACTGACAGCTGGTCCTTGGAGGTCATGTCCCAG
exon_23	GTCCAGGTGCTGCTGTACTTCCTGCAGCTGGAGGCCATCCCTGCCCCGGACAGCAAGAGACAGAGCATCCTGTTCTCCACCGAAGTCTAAAGGTCCCAGTCCATCTCCTGGAGGCGGACAGATGGCCTGGAAACCTCTGGCTAATCGGGCCATCCGTAGAGCGGGAACCTTCCTGAGGTGTCCTTGGGCCACCCCCAAGTGTTGGGCCATCTGCCAAGAGACAGCGACCCAAAGCCGAAGGACAGGTGGCCTGGAAAGATCCCGCCCAGGTCTGGGAGCCCCAGGCTGGCCTCAGACTGTGGTTTTTTATGTGGCCACCTGAGGGCGCCCCAAGCCAGTTCATCTCGGAGTCCAGGCCTGGCCCTGGGAGACAGGGTGAAGGGAGTGGTTTTTATGAACTTAACTTAGAGTCTAAAAGATTTCTACTGGATCACTTGTCAAGATGCGCCCTCTCTGGGGAGAAGGGAACGTGACTGGATTCCCTCACTGTTGTATCTTGAATAAACGCTGCTGCTTCATCCTGTGGGGGCCGTGGCCCTGTCCCTGTGTGGGTGGGGCCTCTTCCATTTCCCTGACTTAGAAACCACACTCCACTTCTAACAGGGTTTGAGAGGCTTAGTCAGCACTGGGTAGCGTTTTGACTCCATTCTTGGCTTTCTTTTTCTTTCCAGAAGGATTTTTGTGCAGAAATGGGTCTTTTGTTGCCATGTTAGTCCTCCTTGGAAGGCAGCTCAGAAGGCCTGTGAAATGTCAGGGGACAGGACCCCCAGGGAGGGAACCCCAGGCTACGCACTTTAGGGTTCGTTCTCCAGGGAGAGCGACCTCGTCCCCCGATCCTGACCGCCCTTCCGGCCCACGCTCTCCTGTTTGGCTTCCACAGGCCTGGACTTCTCTGGCTTCTCTGCCCACACACTCCCTGCCCCCAGTGTCCCTGCCCCTGCCCCAGCACAGGTGACTTCATTTCTGTCCTCTCAGCTCAGTGGACTCGCTCAACTTTTGTATAAGTCTCCACTTGGTGGCAGCAGCTTGCTGATGACTTGTTTTAAAACTTTCATCCTAAATAACCTTTTGATACTTGAATATTTGTAAGTTTTATACATAGTTTCTAATTTTTTTCCGAACAGATCCAGATACCTAATAAGATGCTGGAATGTAATCCCTGGACAATCCGTGTCCTGGCAGCATTTGGTCTTCCTCTAAGCGCCTGGCTCCGCTGTTCTCAGGAGTGGGTTCTGAAGTCTCTGGAGAACAGGATACGTGGAGGGTTAGGAAGGGGCCAGGCCTAGAGACGGGAGACTCCCTCCCGGAGCAGGTGGAGGCACAGGACCATTCGCTACCCCATCTGCCGACACCTGCGGGGGAGCCCAGGCATTCTTTGTAAACCCTCCTGACCACCTGGCTCAAAGAAAACAGAAGCATGGAGACCGCCAAGTATTTTCAAGAAATAACCCCATGAATATTCCATCACTTTTTTAGAAAGAGGGGCTTGGGGCAGGCAGAGGAGAGAAGGGAGAGCAAACTGAGAGCCAAGTTTCCACACGGTCCTGCAGGAGGAGAGGATGCAGCTGCCCAGAGGGAAGCAGGATCACATTTAAGGAAGTGTGTGGGGTCCCTGGATGACACCAGCACCCAGTGCGGCTCTGTCTGGCACCCGCTCCCAAGGTGGGAGGAGTGGGTGTCCCCTGTGTGTCAGTGGGCAGCTCCTGCTGAACCCGCAGCTCACTAGGGAGCCTGACAGTGGGGCCATGCGCCTGACACTCCTCTCTGCTTGTGGACCTGGCAAGGCAGGGAGCAGAAAACAGCCACTTGAAGGCTTTCTGTCTGCGTCTGTGTGCAGTGTGGATTTAGTTGTGCTTTTTTCTTGCTGGGAGAGCACAGCCACCATTTACAAGCAGTGTCACCGTCGTGGGTGGCGAGGACAGAACAGGAGCCTCTGCTCTCTGTACCTATCTGGGCCCGGTGGGCTCCCTTGTCCTGGCTTCCATCTCTGTCTCAGCGACCATTCAGCCCTGCGCAGGAACACGTGTTGCTTAGAAAAGCCAAATCCAGCCTTGTCTCTGCCTCCTCTGGTCTCATGATGTGCATCTGTTACCTTGAAACTGGAAACCAGTCTATCAATGTCTGTGCCAATTTTTTATTCCCTCCCCAACCTCCTTCCCCATACGACTTTTTATTTATGTAGGATGTGTGCTGTCTAATGATGGGATGACCACACTTTTCCATGTTCTAAAAGTGCTCCTCTCCCGCAGGGTCCCAGGGCTGGTGGTTGCTTTGGGTCTACAGCTACGTCTTACCCACCTCCTGCCTCAACAGCCTGTGTGGTGGCAAAGCCGGTGTGGGGCTGGGGAACGCAGCGTTCTCCAGGAGGGGGACCTGGCTCTCCTTCTGCAATGCAGGCGAAGGCCTAGATGCCAGTGTGACCTCCCACAAGGCGTGGCTTCCAGACTCCCCGGCCGGAAGTGATGCTTTTTTGCCTTGGGCCCTGGGTTTGAAGCAGCCTGGCTTTCTCTTGGTAAGTGGCTGGTGTCTTAGCAGCTGCAATCTGAGCTCAGCCACCTACACACCACCGTGGCCGACACTTTCATTAAAAAGTTTCCTGAGACGA
